"filename", "language", "JavaScript", "CSS", "Markdown", "JSON", "HTML", "comment", "blank", "total"
"c:\Users\Airis\Desktop\Front\.vs\ProjectSettings.json", "JSON", 0, 0, 0, 3, 0, 0, 0, 3
"c:\Users\Airis\Desktop\Front\.vs\VSWorkspaceState.json", "JSON", 0, 0, 0, 6, 0, 0, 0, 6
"c:\Users\Airis\Desktop\Front\README.md", "Markdown", 0, 0, 1, 0, 0, 0, 2, 3
"c:\Users\Airis\Desktop\Front\package-lock.json", "JSON", 0, 0, 0, 19422, 0, 0, 1, 19423
"c:\Users\Airis\Desktop\Front\package.json", "JSON", 0, 0, 0, 54, 0, 0, 1, 55
"c:\Users\Airis\Desktop\Front\public\index.html", "HTML", 0, 0, 0, 0, 20, 23, 1, 44
"c:\Users\Airis\Desktop\Front\public\manifest.json", "JSON", 0, 0, 0, 25, 0, 0, 1, 26
"c:\Users\Airis\Desktop\Front\src\App.js", "JavaScript", 51, 0, 0, 0, 0, 0, 9, 60
"c:\Users\Airis\Desktop\Front\src\HOCs\withLoading.js", "JavaScript", 10, 0, 0, 0, 0, 0, 2, 12
"c:\Users\Airis\Desktop\Front\src\components\AllMoviesList.js", "JavaScript", 215, 0, 0, 0, 0, 8, 13, 236
"c:\Users\Airis\Desktop\Front\src\components\AuthForm.js", "JavaScript", 59, 0, 0, 0, 0, 0, 7, 66
"c:\Users\Airis\Desktop\Front\src\components\CinemaForm.js", "JavaScript", 54, 0, 0, 0, 0, 0, 8, 62
"c:\Users\Airis\Desktop\Front\src\components\CinemasList.js", "JavaScript", 50, 0, 0, 0, 0, 0, 2, 52
"c:\Users\Airis\Desktop\Front\src\components\CinemasList.module.css", "CSS", 0, 102, 0, 0, 0, 0, 7, 109
"c:\Users\Airis\Desktop\Front\src\components\CommentCard.js", "JavaScript", 68, 0, 0, 0, 0, 0, 6, 74
"c:\Users\Airis\Desktop\Front\src\components\CommentCard.module.css", "CSS", 0, 42, 0, 0, 0, 0, 9, 51
"c:\Users\Airis\Desktop\Front\src\components\CommentForm.js", "JavaScript", 103, 0, 0, 0, 0, 0, 13, 116
"c:\Users\Airis\Desktop\Front\src\components\CommentForm.module.css", "CSS", 0, 20, 0, 0, 0, 0, 4, 24
"c:\Users\Airis\Desktop\Front\src\components\DeleteButton.js", "JavaScript", 15, 0, 0, 0, 0, 0, 2, 17
"c:\Users\Airis\Desktop\Front\src\components\EditButton.js", "JavaScript", 18, 0, 0, 0, 0, 0, 2, 20
"c:\Users\Airis\Desktop\Front\src\components\Header.module.css", "CSS", 0, 45, 0, 0, 0, 0, 10, 55
"c:\Users\Airis\Desktop\Front\src\components\MovieCard.js", "JavaScript", 101, 0, 0, 0, 0, 0, 7, 108
"c:\Users\Airis\Desktop\Front\src\components\MovieDeleteButton.js", "JavaScript", 14, 0, 0, 0, 0, 0, 2, 16
"c:\Users\Airis\Desktop\Front\src\components\MovieEditButton.js", "JavaScript", 16, 0, 0, 0, 0, 0, 2, 18
"c:\Users\Airis\Desktop\Front\src\components\MovieForm.js", "JavaScript", 69, 0, 0, 0, 0, 0, 11, 80
"c:\Users\Airis\Desktop\Front\src\components\MovieList.js", "JavaScript", 241, 0, 0, 0, 0, 0, 12, 253
"c:\Users\Airis\Desktop\Front\src\components\MovieList.module.css", "CSS", 0, 180, 0, 0, 0, 0, 20, 200
"c:\Users\Airis\Desktop\Front\src\components\ReviewCard.js", "JavaScript", 21, 0, 0, 0, 0, 0, 3, 24
"c:\Users\Airis\Desktop\Front\src\components\ReviewCard.module.css", "CSS", 0, 30, 0, 0, 0, 0, 7, 37
"c:\Users\Airis\Desktop\Front\src\components\ReviewForm.js", "JavaScript", 103, 0, 0, 0, 0, 0, 12, 115
"c:\Users\Airis\Desktop\Front\src\components\ReviewForm.module.css", "CSS", 0, 20, 0, 0, 0, 0, 4, 24
"c:\Users\Airis\Desktop\Front\src\components\ScreeningForm.js", "JavaScript", 56, 0, 0, 0, 0, 0, 13, 69
"c:\Users\Airis\Desktop\Front\src\components\ScreeningList.js", "JavaScript", 217, 0, 0, 0, 0, 0, 13, 230
"c:\Users\Airis\Desktop\Front\src\components\ScreeningList.module.css", "CSS", 0, 169, 0, 0, 0, 2, 24, 195
"c:\Users\Airis\Desktop\Front\src\components\header.js", "JavaScript", 104, 0, 0, 0, 0, 1, 4, 109
"c:\Users\Airis\Desktop\Front\src\components\temp.js", "JavaScript", 122, 0, 0, 0, 0, 0, 14, 136
"c:\Users\Airis\Desktop\Front\src\constants\routes.js", "JavaScript", 2, 0, 0, 0, 0, 0, 2, 4
"c:\Users\Airis\Desktop\Front\src\constants\theme.js", "JavaScript", 12, 0, 0, 0, 0, 0, 2, 14
"c:\Users\Airis\Desktop\Front\src\css\app.module.css", "CSS", 0, 7, 0, 0, 0, 0, 0, 7
"c:\Users\Airis\Desktop\Front\src\css\styles.module.css", "CSS", 0, 81, 0, 0, 0, 0, 14, 95
"c:\Users\Airis\Desktop\Front\src\hooks\useQuery.js", "JavaScript", 17, 0, 0, 0, 0, 0, 7, 24
"c:\Users\Airis\Desktop\Front\src\index.js", "JavaScript", 8, 0, 0, 0, 0, 0, 2, 10
"c:\Users\Airis\Desktop\Front\src\pages\AddCinema.js", "JavaScript", 9, 0, 0, 0, 0, 0, 2, 11
"c:\Users\Airis\Desktop\Front\src\pages\AddMovie.js", "JavaScript", 9, 0, 0, 0, 0, 0, 2, 11
"c:\Users\Airis\Desktop\Front\src\pages\AddScreening.js", "JavaScript", 9, 0, 0, 0, 0, 0, 2, 11
"c:\Users\Airis\Desktop\Front\src\pages\AllMovies.js", "JavaScript", 14, 0, 0, 0, 0, 0, 1, 15
"c:\Users\Airis\Desktop\Front\src\pages\EditCinema.js", "JavaScript", 9, 0, 0, 0, 0, 0, 2, 11
"c:\Users\Airis\Desktop\Front\src\pages\EditMovie.js", "JavaScript", 9, 0, 0, 0, 0, 0, 2, 11
"c:\Users\Airis\Desktop\Front\src\pages\EditScreening.js", "JavaScript", 9, 0, 0, 0, 0, 0, 2, 11
"c:\Users\Airis\Desktop\Front\src\pages\Home.js", "JavaScript", 23, 0, 0, 0, 0, 0, 4, 27
"c:\Users\Airis\Desktop\Front\src\pages\Login.js", "JavaScript", 9, 0, 0, 0, 0, 0, 2, 11
"c:\Users\Airis\Desktop\Front\src\pages\Movies.js", "JavaScript", 22, 0, 0, 0, 0, 0, 5, 27
"c:\Users\Airis\Desktop\Front\src\pages\Register.js", "JavaScript", 9, 0, 0, 0, 0, 0, 2, 11
"c:\Users\Airis\Desktop\Front\src\pages\Screening.js", "JavaScript", 46, 0, 0, 0, 0, 0, 8, 54
"c:\Users\Airis\Desktop\Front\src\services\Delete.js", "JavaScript", 5, 0, 0, 0, 0, 0, 2, 7
"c:\Users\Airis\Desktop\Front\src\services\ErrorBoundary.js", "JavaScript", 19, 0, 0, 0, 0, 0, 6, 25
"c:\Users\Airis\Desktop\Front\src\services\apiService.js", "JavaScript", 8, 0, 0, 0, 0, 0, 2, 10
"Total", "-", 1955, 696, 1, 19510, 20, 34, 319, 22535